<map>
000000000000000000000000000000000000000000000000000000000000000000000000000000000000000000000000000101000000000000000000000000
000000000000000000000000000000000000000000000000000000000000000000000000000000000000000000000000000101000000000000000000000000
000000000000000000000000000000000000000000000000000000000000000000000000000000000000000000000000000101000000000000000000000000
000000000000000000000000000000000000000000000000000000000000080000000000000000000000000000001000000101000000000000000000000000
000000000000000000000000000002000000000000000000000000000000010101010100000001010101010000000000000101000000000000000000000000
000000000000000000000000000000000000000000090000000000000000010000000100000001000000010100000000000101000000000000000000000000
000000000000000000000000000000000000000101010101000000000000010000000100000001000000000101000000000101000000000111111111110000
000000000000000000040000000000000000000100000001000000000000010000000104040401000000000001010000000101000000010100000000000000
010101010101010101010101010101010101010100000001010101010101010000000101010101000000000000010100000101000001010000000000000000
000000000000000000000000000000000000000000000000000000000000000000000000000000000000000000000101000000000101000000000000000000
000000000000000000000000000000000000000000000000000000000000000000000000000000000000000000000001010101010100000000000000000000
000000000000000000000000000000000000000000000000000000000000000000000000000000000000000000000000000000000000000000000000000000
000000000000000000000000000000000000000000000000000000000000000000000000000000000000000000000000000000000000000000000000000000
000000000000000000000000000000000000000000000000000000000000000000000000000000000000000000000000000000000000000000000000000000
</map>
<hint>
undefined
</hint>